7 7 7 7 7 7 7 7 7 7 7 7 7 7 7 7 7 7 7 7 7 7 7 7 7 7 7 7 7 7 7 7 7 7 7 7 7 7 7 7 7 7 7 2 7 7 7 7 7 7 
7 3 3 3 3 7 5 3 3 3 3 3 3 3 3 3 3 3 3 3 3 3 3 3 3 3 3 3 3 3 3 3 3 3 3 3 3 7 3 3 3 3 3 2 0 0 0 0 0 1 
7 3 3 3 3 7 5 5 2 5 3 7 7 7 7 7 7 7 3 3 3 3 3 7 7 7 7 7 7 7 7 7 3 3 3 3 3 7 3 3 3 3 2 2 8 8 0 0 1 1 
7 7 7 5 3 7 5 2 2 5 3 7 7 5 3 3 3 7 3 3 3 5 3 7 3 3 3 3 3 3 3 7 3 3 3 3 3 7 3 3 3 3 2 2 9 8 0 0 1 1 
6 6 7 3 3 7 2 2 2 7 3 7 7 3 3 5 3 7 5 5 3 5 3 7 3 3 3 3 3 3 3 7 7 7 7 7 7 7 3 3 3 3 2 0 0 8 0 1 1 1 
6 6 7 3 5 7 2 2 2 7 3 7 7 3 3 3 3 7 5 5 5 3 3 7 3 3 3 5 5 3 3 5 5 5 5 3 3 3 3 3 3 2 2 0 0 0 0 1 1 1 
6 6 7 3 3 7 2 2 2 7 3 7 3 3 7 7 7 7 7 7 7 7 3 7 3 3 3 5 3 3 3 7 7 7 7 7 7 7 3 3 3 2 0 0 3 3 3 1 1 1 
6 6 7 3 3 7 7 7 7 7 3 7 3 7 7 6 6 6 6 6 6 7 3 7 3 3 3 3 3 3 3 7 3 3 3 3 3 7 3 3 3 2 0 3 3 3 1 1 1 1 
6 6 7 3 3 3 3 3 3 3 3 3 3 7 6 6 6 6 6 6 6 7 3 7 3 3 3 3 3 3 3 7 3 3 3 3 3 7 3 3 2 2 3 3 3 3 1 1 1 1 
6 6 7 5 7 7 7 3 7 7 7 7 7 7 7 7 7 7 7 7 7 7 3 7 7 7 7 7 3 3 3 7 3 3 3 3 3 7 3 3 2 3 3 3 3 3 3 1 1 1 
6 6 7 3 7 6 7 3 7 6 6 6 6 6 6 6 6 6 6 6 6 7 3 7 3 3 3 3 3 3 3 7 3 3 3 3 3 7 3 3 2 2 3 3 3 3 1 1 1 1 
6 6 7 3 7 6 7 3 7 6 6 6 6 6 6 6 6 6 6 6 6 7 3 7 7 7 7 7 3 7 7 7 7 7 3 7 7 7 3 3 3 2 3 3 3 3 3 1 1 1 
6 6 7 3 7 7 7 3 7 7 7 7 7 7 7 7 7 7 6 6 6 7 3 3 3 3 3 3 3 3 3 3 3 3 3 3 3 3 3 3 3 2 3 3 3 3 1 1 1 1 
6 6 7 3 3 3 3 3 3 3 3 3 3 3 3 3 5 7 6 6 7 7 3 7 7 7 7 7 7 7 7 7 7 7 3 7 7 7 3 3 3 10 3 3 3 3 1 1 1 1 
6 6 7 3 7 7 7 7 7 7 7 3 3 5 5 5 5 7 6 6 7 3 3 7 6 6 6 6 6 6 6 7 3 3 3 3 3 7 3 3 3 2 3 0 0 0 1 1 1 1 
6 6 7 3 7 3 5 3 3 3 7 3 3 5 5 3 3 7 6 6 7 3 3 7 6 6 6 6 6 6 6 7 3 3 3 3 3 7 3 3 0 2 0 0 1 1 1 1 1 1 
6 6 7 5 7 5 5 5 3 3 7 3 5 3 5 3 3 7 7 7 7 3 7 7 7 7 7 7 7 7 7 7 7 7 7 7 7 7 3 0 0 2 0 0 1 1 1 1 1 2 
6 6 7 3 7 3 3 3 3 3 3 3 3 3 3 3 3 3 3 3 3 3 3 3 3 3 3 3 3 3 3 3 3 3 3 3 3 3 3 0 2 2 0 1 1 1 1 1 1 2 
6 6 7 3 7 3 3 3 3 3 7 3 3 3 3 3 3 7 7 7 7 7 7 7 7 3 7 7 7 7 7 7 7 7 7 7 7 7 0 0 2 0 0 1 1 1 0 5 5 2 
7 7 7 3 7 7 7 3 7 7 7 7 7 7 3 7 7 7 3 3 3 3 3 3 7 3 7 3 3 3 3 3 3 3 3 3 3 0 0 0 2 0 0 0 0 0 5 5 5 2 
7 3 5 5 7 6 7 3 7 6 6 6 6 7 3 7 3 3 3 3 3 3 3 3 7 3 7 3 3 3 3 3 3 3 3 0 0 0 0 0 2 0 0 0 0 5 5 5 5 2 
7 3 7 7 7 6 7 3 7 6 6 6 6 7 3 7 3 3 3 3 3 3 3 3 7 3 7 3 3 3 3 3 3 3 3 0 0 0 0 0 2 0 0 0 5 5 5 5 5 2 
7 3 7 6 6 6 7 3 7 6 6 6 6 7 5 5 5 3 3 3 3 3 3 5 5 5 7 3 3 3 3 3 3 0 0 0 0 0 0 0 2 0 0 5 5 5 5 5 5 2 
7 3 7 7 7 7 7 3 7 6 6 6 6 7 3 7 5 3 3 3 3 3 3 3 7 5 7 3 3 3 3 0 0 0 0 0 0 0 0 0 2 0 0 5 5 5 5 5 2 2 
7 3 3 3 3 3 3 3 7 6 6 6 6 7 3 7 3 3 3 3 3 3 3 3 7 3 7 3 3 3 0 0 0 0 0 0 0 0 0 0 2 2 5 5 5 5 5 5 2 2 
7 7 7 7 7 7 7 3 7 7 7 7 7 7 3 7 7 7 7 7 7 7 7 7 7 3 7 3 3 0 0 0 0 0 0 0 0 0 0 0 0 2 2 2 2 2 2 2 2 2 
7 3 3 3 3 3 7 3 7 3 3 3 3 3 5 7 0 0 0 0 0 0 0 0 7 3 7 3 3 0 0 0 0 0 0 0 0 0 0 0 0 5 5 5 5 5 2 2 2 2 
7 3 3 3 3 3 7 3 7 3 3 3 3 3 5 7 0 2 2 2 0 0 0 0 7 3 7 3 3 0 0 0 0 0 11 12 0 0 0 0 0 5 5 5 5 5 2 2 2 2 
7 3 3 3 3 3 7 3 7 3 3 3 3 5 5 7 0 2 2 2 2 2 0 0 0 3 3 3 0 3 3 3 0 0 14 13 0 0 0 0 0 5 5 5 5 5 2 2 2 2 
7 3 3 3 3 3 7 3 7 3 3 3 5 3 3 7 0 0 0 2 2 2 2 0 0 3 0 0 0 0 0 0 0 3 3 3 0 0 0 0 0 5 5 5 5 2 2 2 2 2 
7 3 3 3 3 3 7 3 7 3 3 3 5 3 3 7 0 0 0 0 2 2 0 0 0 0 0 0 0 0 0 0 0 3 3 3 3 15 16 0 0 5 5 5 5 2 2 2 2 2 
7 3 3 3 3 3 7 3 7 3 3 3 5 5 5 7 3 0 0 0 0 0 0 0 0 0 3 11 12 0 0 0 15 16 3 3 3 18 17 0 0 5 5 5 5 2 2 2 2 2 
7 7 7 7 7 7 7 3 7 3 3 3 3 3 5 7 3 0 0 0 0 0 0 0 0 0 3 14 13 0 0 0 18 17 0 0 0 0 0 0 0 5 5 5 5 2 2 2 2 2 
7 3 3 3 3 3 3 3 7 3 3 3 3 3 3 7 3 0 0 0 0 0 0 0 15 16 3 0 0 0 0 0 0 0 0 0 3 0 0 0 0 0 5 5 5 5 2 2 2 2 
7 7 7 7 7 7 7 3 7 7 7 7 7 7 3 7 3 3 0 0 0 0 0 0 18 17 3 0 0 0 0 0 0 15 16 0 3 0 0 0 0 0 0 0 5 5 2 2 2 2 
7 3 3 3 3 3 7 3 3 3 3 3 3 3 3 7 3 3 0 0 0 0 0 0 0 0 3 0 0 0 0 0 0 18 17 0 0 0 0 15 16 0 0 0 0 0 2 2 2 2 
7 3 0 0 3 3 7 7 7 7 7 7 7 7 3 7 3 3 0 0 0 0 0 0 15 16 3 0 0 0 0 0 0 0 0 0 0 0 0 18 17 0 0 0 0 0 2 2 2 2 
7 3 0 0 0 3 3 3 3 3 3 3 3 7 3 7 3 3 0 0 0 0 0 0 18 17 3 0 0 0 0 0 0 0 0 0 3 0 0 0 0 0 0 0 0 8 2 2 2 2 
7 3 0 0 0 0 0 3 3 3 3 3 3 3 3 3 3 3 0 0 0 0 0 3 3 3 3 0 0 0 0 0 0 0 0 0 3 15 16 0 0 8 0 0 0 0 2 2 2 2 
7 3 0 0 0 0 0 0 0 0 0 0 3 3 3 3 0 0 0 0 0 0 0 0 11 12 0 0 0 0 0 0 0 0 0 0 3 18 17 0 0 0 0 0 8 2 2 2 2 2 
7 0 0 0 0 0 0 0 0 0 0 0 0 0 0 0 0 0 0 11 12 3 0 0 14 13 0 0 0 0 0 0 0 0 0 0 3 3 3 3 0 0 0 0 0 2 2 2 2 2 
7 0 0 0 0 0 0 0 0 0 0 0 0 0 0 0 0 0 0 14 13 3 0 0 0 0 0 0 0 0 0 0 0 0 0 0 0 8 0 0 8 0 0 2 2 2 2 2 2 2 
8 8 8 0 0 0 0 0 0 0 0 0 8 0 0 0 0 8 0 0 0 3 0 0 0 0 0 0 0 0 0 0 8 0 0 0 8 0 0 0 0 0 2 2 2 2 2 2 2 2 
8 8 8 0 0 0 0 0 0 0 0 0 8 0 0 0 8 0 0 0 0 3 0 0 0 0 0 0 0 0 0 0 0 0 8 0 0 0 0 0 2 2 2 2 2 2 2 2 2 2 
8 8 8 8 8 0 0 0 0 0 0 0 0 0 0 0 0 0 0 0 0 3 8 0 0 0 0 0 8 0 0 0 0 0 8 0 8 0 0 2 2 2 2 2 2 2 2 2 2 2 
8 8 8 8 8 8 8 0 0 0 0 0 0 0 0 0 0 0 0 5 5 5 8 8 0 0 0 0 0 0 0 0 0 0 0 0 2 2 2 2 2 2 2 2 2 2 2 2 2 2 
8 8 8 8 8 8 8 8 8 0 0 0 0 0 0 0 0 0 5 5 5 5 8 8 8 0 0 0 0 0 0 0 8 0 2 2 2 2 2 2 2 2 2 2 2 2 2 2 2 2 
8 8 8 8 8 8 8 8 0 0 0 0 0 0 0 0 5 5 5 5 5 5 5 5 5 8 2 2 2 2 2 2 2 2 2 2 2 2 2 2 2 2 2 2 2 2 2 2 2 2 
8 8 8 8 8 8 8 8 2 2 2 2 2 2 2 2 2 2 2 2 2 2 2 2 2 2 2 2 2 2 2 2 2 2 2 2 2 2 2 2 2 2 2 2 2 2 2 2 2 2 
8 8 8 8 8 8 8 8 2 2 2 2 2 2 2 2 2 2 2 2 2 2 2 2 2 2 2 2 2 2 2 2 2 2 2 2 2 2 2 2 2 2 2 2 2 2 2 2 2 2 
