7 7 7 7 7 7 7 7 7 7 7 7 7 7 7 7 7 7 7 7 7 7 2 2 2 7 7 7 7 7 7 7 7 7 7 7 7 7 7 7 7 7 7 7 7 7 7 7 7 7 
7 3 3 0 0 0 0 0 0 8 8 8 8 8 8 8 0 0 0 0 0 0 2 2 2 0 0 0 0 0 0 0 0 0 0 0 0 0 0 0 0 8 0 0 0 0 15 16 0 7 
7 0 3 0 0 0 0 0 8 8 8 8 8 8 8 8 8 0 0 0 0 0 2 2 2 0 0 0 0 0 0 0 0 0 0 0 0 0 0 0 8 8 0 8 8 0 18 17 0 7 
7 0 3 0 0 0 0 0 8 8 8 8 8 8 8 8 8 0 0 0 0 0 2 2 2 0 0 0 0 0 0 0 0 0 0 0 0 0 0 0 0 0 0 8 9 8 0 0 0 7 
7 0 3 0 0 0 0 0 0 8 8 8 8 8 8 8 8 0 0 0 0 0 2 2 2 0 0 0 0 0 0 0 0 0 0 0 0 3 3 3 3 3 0 0 0 8 0 8 0 7 
7 0 3 0 0 0 0 0 0 0 0 0 0 0 0 0 0 0 0 0 0 0 2 2 2 0 0 0 0 0 0 0 0 0 0 0 3 3 0 0 0 0 0 0 0 0 0 8 0 7 
7 0 3 0 0 0 0 0 0 0 0 0 0 0 0 0 0 0 0 0 0 0 2 2 2 0 0 0 0 0 0 0 3 3 3 3 3 0 0 0 0 0 0 0 0 0 0 8 0 7 
7 0 3 3 3 3 3 3 3 3 3 3 3 3 3 3 3 3 3 3 3 3 10 10 10 3 3 3 3 3 3 3 3 0 0 0 0 0 3 0 0 0 0 0 0 0 0 0 0 7 
7 0 0 0 0 0 0 0 3 0 0 0 0 0 0 0 0 0 0 0 0 0 2 2 2 0 0 0 0 0 0 8 3 0 0 0 0 0 3 0 15 16 0 0 0 0 0 0 0 7 
7 0 0 0 0 8 8 0 3 0 0 0 0 0 0 0 0 0 0 0 0 0 2 2 2 0 0 0 0 0 0 0 3 0 0 15 16 0 3 0 18 17 0 0 8 0 0 0 0 7 
7 0 0 0 8 8 8 8 3 0 0 0 11 12 0 0 0 0 0 0 0 0 2 2 2 0 0 0 0 0 0 8 3 0 0 18 17 0 0 0 0 0 0 0 8 0 0 0 0 7 
7 0 0 0 8 8 8 8 3 0 0 0 14 13 0 0 0 0 0 0 0 0 2 2 2 0 0 0 0 0 0 0 3 0 0 0 0 0 0 0 0 0 0 0 0 0 0 0 0 7 
7 0 0 0 8 8 8 0 3 0 0 0 0 0 0 0 0 0 0 0 0 0 2 2 2 0 0 0 0 0 0 8 3 0 0 0 0 15 16 0 0 0 0 0 0 0 0 0 0 7 
7 0 0 0 0 0 0 0 3 0 0 0 0 0 0 0 0 0 0 0 0 0 2 2 0 0 0 0 0 0 0 0 3 0 0 0 0 18 17 0 0 0 0 0 0 0 0 8 0 7 
7 0 0 0 0 0 0 0 3 0 0 0 0 0 0 0 0 0 0 0 0 2 2 2 0 0 0 0 0 0 0 8 3 0 0 0 0 0 0 0 0 0 0 0 0 8 8 8 0 7 
7 0 0 0 0 0 0 0 3 0 0 0 0 11 12 0 0 0 0 0 2 2 2 0 0 0 0 0 0 0 0 0 3 0 0 0 0 0 0 0 0 0 0 0 8 8 8 0 0 7 
7 0 0 0 11 12 0 0 0 0 0 0 0 14 13 0 0 0 0 0 2 2 2 0 0 0 0 8 0 0 0 8 3 0 0 0 0 0 0 0 0 0 0 0 8 8 0 0 0 7 
7 0 0 0 14 13 0 0 0 0 0 0 0 0 0 0 0 0 0 2 2 2 0 0 0 0 8 8 0 0 0 0 3 0 0 0 0 0 0 0 0 0 0 8 8 8 0 0 0 7 
7 0 0 0 0 0 0 0 0 0 0 0 0 0 0 0 0 0 2 2 2 2 0 0 0 8 8 0 0 0 0 8 3 0 0 0 0 0 0 0 0 0 0 8 8 0 0 0 0 7 
7 0 0 0 0 0 0 0 0 0 0 0 0 0 0 0 2 2 2 2 0 0 0 0 0 8 0 0 0 0 0 0 3 0 0 0 0 0 0 0 0 0 0 8 8 0 0 0 0 7 
7 0 0 0 0 0 0 0 0 0 0 0 0 0 0 2 2 2 2 0 0 0 0 0 0 0 0 0 0 0 0 8 3 0 11 12 0 0 0 0 0 0 0 8 8 8 0 0 0 7 
2 2 2 2 2 2 2 2 2 2 2 2 2 2 2 2 2 2 0 0 0 0 0 0 0 0 0 0 0 0 0 0 3 0 14 13 0 0 0 0 0 0 0 8 8 8 8 0 0 7 
2 2 2 2 2 2 2 2 2 2 2 2 2 2 2 2 0 0 0 0 0 8 8 0 0 0 0 0 0 0 0 8 3 0 0 0 0 0 0 0 15 16 0 0 0 8 8 8 0 7 
7 0 0 0 0 0 0 0 0 0 0 0 0 0 0 0 0 0 0 0 8 8 0 0 0 0 0 0 0 0 0 0 3 0 0 0 0 0 0 0 18 17 0 0 0 0 8 8 0 7 
7 0 0 0 15 16 0 0 0 0 0 0 0 0 0 0 0 0 0 0 8 0 0 0 0 0 0 0 0 0 0 8 3 3 3 3 3 3 3 3 3 3 3 0 0 0 8 8 8 7 
7 0 0 0 18 17 0 0 0 0 0 0 0 0 0 0 0 0 0 8 0 0 0 0 0 0 0 0 0 0 0 0 3 0 0 0 0 0 0 0 0 0 0 0 0 0 0 8 8 7 
7 0 0 3 3 3 0 0 0 0 0 0 0 0 0 0 0 0 0 0 0 0 0 0 0 0 0 0 0 0 0 8 3 0 0 0 0 0 0 0 0 0 0 0 0 0 0 0 0 7 
7 0 3 3 0 0 0 0 0 0 0 8 8 8 8 8 8 0 0 0 0 0 0 0 0 0 0 0 0 0 0 0 3 0 11 12 0 0 0 0 0 0 0 0 0 0 0 0 0 7 
7 0 3 0 0 8 8 8 8 0 0 0 0 0 0 0 0 0 0 0 0 0 0 0 0 0 0 0 0 0 8 3 3 0 14 13 0 0 0 0 0 0 0 0 0 0 0 0 0 7 
7 0 0 0 0 0 0 0 0 0 0 0 0 0 0 0 0 0 0 0 0 0 0 0 0 0 0 0 8 0 0 3 0 0 0 0 0 0 0 8 11 12 0 0 0 0 0 0 0 7 
7 0 0 8 0 8 0 0 0 0 0 0 0 0 0 0 0 15 16 0 0 0 0 0 0 0 0 0 0 3 3 3 0 0 0 0 0 0 0 0 14 13 0 0 0 0 0 0 0 7 
7 0 0 0 0 0 0 0 0 0 0 0 0 0 0 0 0 18 17 0 0 8 0 8 0 8 0 8 3 0 0 0 0 0 15 16 0 0 0 0 0 0 0 0 0 0 0 0 0 7 
7 0 0 0 0 0 0 0 15 16 0 0 0 0 0 0 0 0 0 8 0 0 3 3 3 3 3 3 3 0 0 0 0 0 18 17 0 0 0 0 0 0 0 0 0 0 0 0 0 7 
7 0 0 0 0 0 0 0 18 17 0 0 0 0 0 8 0 8 0 0 3 3 3 0 0 0 0 0 0 0 0 0 3 0 0 0 0 0 8 0 0 0 0 0 0 2 2 2 0 7 
7 0 0 0 0 0 0 0 0 0 0 0 3 3 3 3 3 3 3 3 0 0 0 0 0 0 0 0 0 0 0 8 3 3 3 3 0 0 3 3 0 0 0 0 2 2 2 2 0 7 
7 3 3 3 3 3 3 3 3 3 3 3 0 0 0 0 0 0 0 0 0 0 0 0 0 0 0 15 16 0 0 0 0 0 0 0 0 0 0 3 3 3 0 0 5 5 2 2 0 7 
7 0 0 0 0 0 0 0 0 0 0 0 0 0 0 0 0 0 0 0 0 0 0 0 0 0 0 18 17 0 0 0 0 15 16 0 0 0 15 16 0 3 0 0 0 5 5 0 0 7 
7 0 0 11 12 0 0 0 0 3 3 0 0 0 0 0 0 0 8 8 8 0 0 0 0 0 0 0 0 0 0 0 0 18 17 0 0 0 18 17 8 0 0 0 0 0 0 0 0 7 
7 0 0 14 13 0 0 0 0 3 0 0 0 0 0 0 0 0 8 0 0 0 0 0 0 0 0 0 0 0 0 0 0 0 0 0 0 0 0 0 0 0 0 0 0 0 0 0 0 7 
7 0 0 0 0 0 0 0 0 3 0 0 0 0 0 0 0 8 0 0 0 0 0 0 0 8 0 0 0 0 0 8 0 0 0 0 8 0 0 0 0 0 0 0 0 0 0 0 0 7 
7 0 0 0 0 0 0 15 16 3 3 0 0 0 0 0 0 0 0 0 0 0 0 0 0 0 0 0 0 0 0 0 0 0 8 0 0 0 0 0 0 0 0 0 8 0 0 0 0 7 
7 0 0 0 0 0 0 18 17 0 3 3 0 0 0 0 0 0 0 11 12 0 0 0 0 15 16 0 8 0 0 8 0 0 0 0 0 0 0 0 0 0 0 0 8 0 0 0 0 7 
7 0 0 0 0 0 0 0 0 0 0 3 3 3 0 0 0 0 0 14 13 0 0 0 0 18 17 0 0 0 0 0 0 0 0 8 0 0 8 8 0 0 0 0 8 0 0 0 0 7 
2 0 0 0 0 0 0 0 0 0 0 0 0 0 0 0 0 3 3 3 3 3 3 3 3 0 0 0 0 0 0 0 0 0 0 0 0 0 0 0 0 0 0 0 0 0 8 8 8 7 
2 2 2 0 0 0 0 0 0 0 0 0 0 0 0 0 0 0 0 0 0 0 0 0 3 3 3 0 0 0 0 0 0 0 0 0 0 0 0 0 0 0 0 0 0 8 8 0 0 7 
2 2 2 2 0 0 0 0 0 0 0 0 0 0 0 0 0 0 0 0 0 11 12 0 0 0 15 16 0 3 3 3 3 3 3 3 3 0 0 0 0 0 0 0 8 8 0 0 0 7 
2 2 2 2 2 5 5 5 0 0 0 0 0 0 0 0 0 0 0 0 0 14 13 0 0 0 18 17 0 0 0 0 0 0 0 0 0 3 3 3 3 0 0 3 3 3 3 0 0 7 
2 2 2 2 2 2 2 5 5 0 0 0 0 0 0 0 0 0 0 0 0 0 0 0 0 0 0 0 0 0 0 0 0 0 0 0 0 0 0 0 0 0 0 8 0 0 0 0 0 7 
2 2 2 2 2 2 2 2 5 5 5 0 0 0 0 0 0 0 0 0 0 0 0 0 0 0 0 0 0 0 0 0 0 0 0 0 0 0 0 0 0 8 8 8 0 0 0 0 0 7 
2 2 2 2 2 2 2 2 2 7 7 7 7 7 7 7 7 7 7 7 7 7 7 7 7 7 7 7 7 7 7 7 7 7 7 7 7 7 7 7 7 7 7 7 7 7 7 7 7 7 
