7 7 7 7 7 7 7 7 7 7 7 7 7 7 7 7 7 7 7 7 7 7 7 7 7 7 7 7 7 7 7 7 7 7 7 7 7 7 7 7 7 7 7 7 7 7 7 7 7 7 
7 3 3 3 3 7 5 3 3 3 3 3 3 3 3 3 3 3 3 3 3 3 3 3 3 3 3 3 3 3 3 3 3 3 3 3 3 7 3 3 3 3 3 3 3 3 3 3 3 1 
7 3 3 3 3 7 5 5 2 5 3 7 7 7 7 7 7 7 3 3 3 3 3 7 7 7 7 7 7 7 7 7 3 3 3 3 3 7 3 3 3 3 3 3 3 3 3 3 1 1 
7 7 7 5 3 7 5 2 2 5 3 7 7 5 3 3 3 7 3 3 3 5 3 7 3 3 3 3 3 3 3 7 3 3 3 3 3 7 3 3 3 3 3 3 3 3 3 3 1 1 
6 6 7 3 3 7 2 2 2 7 3 7 7 3 3 5 3 7 5 5 3 5 3 7 3 3 3 3 3 3 3 7 7 7 7 7 7 7 3 3 3 3 3 3 3 3 3 1 1 1 
6 6 7 3 5 7 2 2 2 7 3 7 7 3 3 3 3 7 5 5 5 3 3 7 3 3 3 5 5 3 3 5 5 5 5 3 3 3 3 3 3 3 3 3 3 3 3 1 1 1 
6 6 7 3 3 7 2 2 2 7 3 7 3 3 7 7 7 7 7 7 7 7 3 7 3 3 3 5 3 3 3 7 7 7 7 7 7 7 3 3 3 3 3 3 3 3 3 1 1 1 
6 6 7 3 3 7 7 7 7 7 3 7 3 7 7 6 6 6 6 6 6 7 3 7 3 3 3 3 3 3 3 7 3 3 3 3 3 7 3 3 3 3 3 3 3 3 1 1 1 1 
6 6 7 3 3 3 3 3 3 3 3 3 3 7 6 6 6 6 6 6 6 7 3 7 3 3 3 3 3 3 3 7 3 3 3 3 3 3 3 3 3 3 3 3 3 3 1 1 1 1 
6 6 7 5 7 7 7 3 7 7 7 7 7 7 7 7 7 7 7 7 7 7 3 7 7 7 7 7 3 3 3 7 3 3 3 3 3 3 3 3 3 3 3 3 3 3 3 1 1 1 
6 6 7 3 7 6 7 3 7 6 6 6 6 6 6 6 6 6 6 6 6 7 3 7 3 3 3 3 3 3 3 7 3 3 3 3 3 3 3 3 3 3 3 3 3 3 1 1 1 1 
6 6 7 3 7 6 7 3 7 6 6 6 6 6 6 6 6 6 6 6 6 7 3 7 7 7 7 7 3 7 7 7 3 3 3 3 3 3 3 3 3 3 3 3 3 3 3 1 1 1 
6 6 7 3 7 7 7 3 7 7 7 7 7 7 7 7 7 7 6 6 6 7 3 3 3 3 3 3 3 3 3 3 3 3 3 3 3 3 3 3 3 3 3 3 3 3 1 1 1 1 
6 6 7 3 3 3 3 3 3 3 3 3 3 3 3 3 5 7 6 6 7 7 3 7 7 7 7 7 7 7 7 7 3 3 3 3 3 3 3 3 3 3 3 3 3 3 1 1 1 1 
6 6 7 3 7 7 7 7 7 7 7 3 3 5 5 5 5 7 6 6 7 3 3 7 6 6 6 6 6 6 6 7 3 3 3 3 3 3 3 3 3 3 3 0 0 0 1 1 1 1 
6 6 7 3 7 3 5 3 3 3 7 3 3 5 5 3 3 7 6 6 7 3 3 7 6 6 6 6 6 6 6 7 3 3 3 3 3 3 3 3 0 0 0 0 1 1 1 1 1 1 
6 6 7 5 7 5 5 5 3 3 7 3 5 3 5 3 3 7 7 7 7 3 7 7 7 7 7 7 7 7 7 7 3 3 3 3 3 3 3 0 0 0 0 0 1 1 1 1 1 2 
6 6 7 3 7 3 3 3 3 3 3 3 3 3 3 3 3 3 3 3 3 3 3 3 3 3 3 3 3 3 3 3 3 3 3 3 3 3 3 0 0 0 0 1 1 1 1 1 1 2 
6 6 7 3 7 3 3 3 3 3 7 3 3 3 3 3 3 7 7 7 7 7 7 7 7 3 7 7 7 7 7 7 7 3 3 3 3 3 0 0 0 0 0 1 1 1 0 5 5 2 
7 7 7 3 7 7 7 3 7 7 7 7 7 7 3 7 7 7 3 3 3 3 3 3 7 3 7 3 3 3 3 3 3 3 3 3 3 0 0 0 0 0 0 0 0 0 5 5 5 2 
7 3 5 5 7 6 7 3 7 6 6 6 6 7 3 7 3 3 3 3 3 3 3 3 7 3 7 3 3 3 3 3 3 3 3 0 0 0 0 0 0 0 0 0 0 5 5 5 5 2 
7 3 7 7 7 6 7 3 7 6 6 6 6 7 3 7 3 3 3 3 3 3 3 3 7 3 7 3 3 3 3 3 3 3 3 0 0 0 0 0 0 0 0 0 5 5 5 5 5 2 
7 3 7 6 6 6 7 3 7 6 6 6 6 7 5 5 5 3 3 3 3 3 3 5 5 5 7 3 3 3 3 3 3 0 0 0 0 0 0 0 0 0 0 5 5 5 5 5 5 2 
7 3 7 7 7 7 7 3 7 6 6 6 6 7 3 7 5 3 3 3 3 3 3 3 7 5 7 3 3 3 3 0 0 0 0 0 0 0 0 0 0 0 0 5 5 5 5 5 2 2 
7 3 3 3 3 3 3 3 7 6 6 6 6 7 3 7 3 3 3 3 3 3 3 3 7 3 7 3 3 3 0 0 0 0 0 0 0 0 0 0 0 0 5 5 5 5 5 5 2 2 
7 7 7 7 7 7 7 3 7 7 7 7 7 7 3 7 7 7 7 7 7 7 7 7 7 3 7 3 3 0 0 0 0 0 0 0 0 0 0 0 0 5 5 5 5 5 5 2 2 2 
7 3 3 3 3 3 7 3 7 3 3 3 3 3 5 7 0 0 0 0 0 0 0 0 7 3 7 3 3 0 0 0 0 0 0 0 0 0 0 0 0 5 5 5 5 5 2 2 2 2 
7 3 3 3 3 3 7 3 7 3 3 3 3 3 5 7 0 2 2 2 0 0 0 0 7 3 7 3 3 0 0 0 0 0 0 0 0 0 0 0 0 5 5 5 5 5 2 2 2 2 
7 3 3 3 3 3 7 3 7 3 3 3 3 5 5 7 0 2 2 2 2 2 0 0 0 3 3 3 0 0 0 0 0 0 0 0 0 0 0 0 0 5 5 5 5 5 2 2 2 2 
7 3 3 3 3 3 7 3 7 3 3 3 5 3 3 7 0 0 0 2 2 2 2 0 0 3 0 0 0 0 0 0 0 0 0 0 0 0 0 0 0 5 5 5 5 2 2 2 2 2 
7 3 3 3 3 3 7 3 7 3 3 3 5 3 3 7 0 0 0 0 2 2 0 0 0 0 0 0 0 0 0 0 0 0 0 0 0 0 0 0 0 5 5 5 5 2 2 2 2 2 
7 3 3 3 3 3 7 3 7 3 3 3 5 5 5 7 3 0 0 0 0 0 0 0 0 0 0 0 0 0 0 0 0 0 0 0 0 0 0 0 0 5 5 5 5 2 2 2 2 2 
7 7 7 7 7 7 7 3 7 3 3 3 3 3 5 7 3 0 0 0 0 0 0 0 0 0 0 0 0 0 0 0 0 0 0 0 0 0 0 0 0 5 5 5 5 2 2 2 2 2 
7 3 3 3 3 3 3 3 7 3 3 3 3 3 3 7 3 0 0 0 0 0 0 0 0 0 0 0 0 0 0 0 0 0 0 0 0 0 0 0 0 0 5 5 5 5 2 2 2 2 
7 7 7 7 7 7 7 3 7 7 7 7 7 7 3 7 3 3 0 0 0 0 0 0 0 0 0 0 0 0 0 0 0 0 0 0 0 0 0 0 0 0 0 0 5 5 2 2 2 2 
7 3 3 3 3 3 7 3 3 3 3 3 3 3 3 7 3 3 0 0 0 0 0 0 0 0 0 0 0 0 0 0 0 0 0 0 0 0 0 0 0 0 0 0 0 0 2 2 2 2 
7 3 0 0 3 3 7 7 7 7 7 7 7 7 3 7 3 3 0 0 0 0 0 0 0 0 0 0 0 0 0 0 0 0 0 0 0 0 0 0 0 0 0 0 0 0 2 2 2 2 
7 3 0 0 0 3 3 3 3 3 3 3 3 7 3 7 3 3 0 0 0 0 0 0 0 0 0 0 0 0 0 0 0 0 0 0 0 0 0 0 0 0 0 0 0 8 2 2 2 2 
7 3 0 0 0 0 0 3 3 3 3 3 3 3 3 3 3 3 0 0 0 0 0 0 0 0 0 0 0 0 0 0 0 0 0 0 0 0 0 0 0 8 0 0 0 0 2 2 2 2 
7 3 0 0 0 0 0 0 0 0 0 0 3 3 3 3 0 0 0 0 0 0 0 0 0 0 0 0 0 0 0 0 0 0 0 0 0 0 0 0 0 0 0 0 8 2 2 2 2 2 
7 0 0 0 0 0 0 0 0 0 0 0 0 0 0 0 0 0 0 0 0 0 0 0 0 0 0 0 0 0 0 0 0 0 0 0 0 0 0 0 0 0 0 0 0 2 2 2 2 2 
7 0 0 0 0 0 0 0 0 0 0 0 0 0 0 0 0 0 0 0 0 0 0 0 0 0 0 0 0 0 0 0 0 0 0 0 0 8 0 0 8 0 0 2 2 2 2 2 2 2 
8 8 8 0 0 0 0 0 0 0 0 0 0 0 0 0 0 0 0 0 0 0 0 0 0 0 0 0 0 0 0 0 8 0 0 0 8 0 0 0 0 0 2 2 2 2 2 2 2 2 
8 8 8 0 0 0 0 0 0 0 0 0 0 0 0 0 0 0 0 0 0 0 0 0 0 0 0 0 0 0 0 0 0 0 8 0 0 0 0 0 2 2 2 2 2 2 2 2 2 2 
8 8 8 8 8 0 0 0 0 0 0 0 0 0 0 0 0 0 0 0 0 0 0 0 0 0 0 0 8 0 0 0 0 0 8 0 8 0 0 2 2 2 2 2 2 2 2 2 2 2 
8 8 8 8 8 8 8 0 0 0 0 0 0 0 0 0 0 0 0 0 0 0 0 0 0 0 0 0 0 0 0 0 0 0 0 0 2 2 2 2 2 2 2 2 2 2 2 2 2 2 
8 8 8 8 8 8 8 8 8 0 0 0 0 0 0 0 0 0 0 0 0 0 0 0 0 0 0 0 0 0 0 0 8 0 2 2 2 2 2 2 2 2 2 2 2 2 2 2 2 2 
8 8 8 8 8 8 8 8 0 0 0 0 0 0 0 0 0 0 0 0 0 0 0 0 0 0 2 2 2 2 2 2 2 2 2 2 2 2 2 2 2 2 2 2 2 2 2 2 2 2 
8 8 8 8 8 8 8 8 2 2 2 2 2 2 2 2 2 2 2 2 2 2 2 2 2 2 2 2 2 2 2 2 2 2 2 2 2 2 2 2 2 2 2 2 2 2 2 2 2 2 
8 8 8 8 8 8 8 8 2 2 2 2 2 2 2 2 2 2 2 2 2 2 2 2 2 2 2 2 2 2 2 2 2 2 2 2 2 2 2 2 2 2 2 2 2 2 2 2 2 2 
